111111
100001
1C0001
10E001
111111
