111111
1P0001
100001
1C0001
1000E1
11111
