111111
1P0X01
100001
1C0E11
111111
