111111
1P0C01
1000A1
1C0E11
111111
