111111
1P0001
111101
1C01E1
111111
