111111
1P0C01
100C01
1C0E11
1C0E11
111111
