111111
1P0C01
100001
1C0E11
1C0E11
111111