111111
1P0001
10001
10C0E1
111111
