111111
1P0C01
111111
100001
10CE01
111111
