11111111
10E0P001
1100C0C1
11111111