11111111
1PE00001
1100C0C1
11111111