11111111111111111
1P000000C00000001
11111111011111101
10000C000000000E1
11111111111111111
