1111111111111111111111
10E0P000000000000000C1
1000C0C000000000000001
1000000000C00000000001
1111000000000000000001
1100000000000000000001
1000000000000000000001
1100000001010000000001
1000000000000000000001
1100000000011110000001
1111111111111111111111
