1111111111111111111111
10E0P00000000000000MC1
1000C0C0000000000000M1
1000000000C00000000001
1111000000000000000001
11000000000000M0M00001
1000000000000000000001
1100000001010000000001
1000000000000000000001
1100000000011110000001
1111111111111111111111
